NO ./src/textures/stonewall.xpm
SO ./src/textures/wood.xpm
WE ./src/textures/red.xpm
EA ./src/textures/grey.xpm

F 55,55,55
C 111,111,111

111111111111111111
1001B10010000000T1
100004001000000001
1100T0041411444111
1000N0042000000001
1B1000041000000001
100001001000000001
1B0101001B000000B1
111111111111111111