NO ./src/textures/tree.xpm
SO ./src/textures/red.xpm
WE ./src/textures/purple.xpm
EA ./src/textures/grey.xpm

F 220,100,0
C 225,30,0

111111111
100101001
100101001
110000011
100000001
111000111
1001N1001
100101001
111111111