NO ./src/textures/stonewall.xpm
SO ./src/textures/wood.xpm
WE ./src/textures/red.xpm
EA ./src/textures/grey.xpm

F 55,55,55
C 111,111,111

111111111111111111
1001B10010000000T1
10000400100000000111111
110000041411144110000h1
1000N004200010000000001
1B1000041000000000000B1
10000100100100100111111
1B01010H1B000000B1
111111111111111111