NO ./src/textures/tree.xpm
SO ./src/textures/red.xpm
WE ./src/textures/purple.xpm
EA ./src/textures/grey.xpm

F 55,55,55
C 111,111,111

111111111
100101001
100101001
110000011
1000S0001
111000111
100101001
100101001
111111111