NO ./src/textures/stonewall.xpm
SO ./src/textures/tree.xpm
WE ./src/textures/red.xpm
EA ./src/textures/grey.xpm

F 55,55,55
C 111,111,111

111111111111111111
100101001000000001
100101001000000001
110000011011000111
1000N0002000000001
111000121000000001
100001001000000001
100101001000000001
111111111111111111