NO
./src/textures/stonewall.xpm
SO./src/textures/red.xpm
SO ./src/textures/red.xpm
WE ./src/textures/wood.xpm
EA ./src/textures/grey.xpm

C 100,100,100
FA 111,111,111

        1111111111111111111111111
        100000000T1100000000000h1
        1011000001110000000000001
        1001000000100000000000001
1111111110110000011100000000000B1
1B0000000011000001110111114111111
11110111111141411100000010001
11110111111141411101010010001
1B000000110101011100000010001
10000000000000002000000000001
10000000000000001101010010001
10000001110101011111011110N01
1H1101B1 1110101 10111101B001
11111111 1111111 111111111111