NO ./src/textures/tree.xpm
SO ./src/textures/red.xpm
WE ./src/textures/purple.xpm
EA ./src/textures/grey.xpm

F 220,100,0
C 225,30,0

111111111
100101001
100101001
110000011
1000E0001
111000111
100101001
100101001
111111111