NO ./src/textures/stonewall.xpm
SO ./src/textures/wood.xpm
WE ./src/textures/red.xpm
EA ./src/textures/grey.xpm

F 55,55,55
C 111,111,111

111111111111111111
1001B1001h000000T1
100004001000000001
110000041411144111
1000N0042000100001
1B1000041000000001
100001001001001001
1B01010H1B000000B1
111111111111111111